*s=the
*d=the
*de=the
*z=to
*Auto=car
*badi=pool
*bett=bed
*bitzeli=bit
*blueme=flower
*bratwurscht=sausage
*brüeder=brother
*familie=family
*au=also
*das=that
*ferie=holiday/vacation
*fründ=friend/boyfriend
*fründin=friend/girlfriend
*guet=good
*guete=good
*grüezi=hello
*hallo=hello
*hoi=hello
*zäme=together
*ich=I
*bi=am
*isch=is
*es=it
*ha=have
*gärn=like
*milch=milk
*dich=you
*schoggi=chocolate
*schwiiz=Switzerland
*oder=or
*öppis=something
*nacht=night
*aabig=evening
*schuel-school
*tschüss=bye
*velo=bicycle
*was=what
*wo=where
*wie=how
*wuche=week
*zmorge=breakfast
*zmittag=lunch
zvieri=snack
*znacht=dinner
*morge=morning
*morn=tomorrow
*gah=to go
*gasch=you go
*jetzt=now
*parat=ready
*fertig=finished
*schlafe=sleep
*spöter=later
*ässe=eat
*trinke=drink
grad=now
*aber=but
*also=so
*verstah=to understand
*hend=we have
*hesch=you have
*mier=we
*sii=to be
*si=her/them
*du=you
*er=he
*Griffin=Griffin
*ned=not